{
  "rooms": [
    {
      "name": "Crossroads Trap Room",
      "layout": [
        "             ",
        "             ",
        "             ",
        "             ",
        "##$   *   $##",
        "      *      ",
        "    *****    ",
        "      *      ",
        "##$   *   $##",
        "             ",
        "             ",
        "             ",
        "             "
      ]
    },
    {
      "name": "Spike Maze",
      "layout": [
        "   *     *   ",
        "  * #   # *  ",
        " *  #   #  * ",
        "*           *",
        "    #   #    ",
        "    #   #    ",
        "             ",
        "    #   #    ",
        "    #   #    ",
        "*           *",
        " *  #   #  * ",
        "  * #   # *  ",
        "   *     *   "
      ]
    },
    {
      "name": "Arrow Gauntlet",
      "layout": [
        "             ",
        "             ",
        "$$$$     $$$$",
        "             ",
        "    # # #    ",
        "    # # #    ",
        "             ",
        "    # # #    ",
        "    # # #    ",
        "             ",
        "$$$$     $$$$",
        "             ",
        "             "
      ]
    },
    {
      "name": "Trap Arena",
      "layout": [
        "             ",
        "             ",
        "  *       *  ",
        " *$*     *$* ",
        "             ",
        "    =====    ",
        "             ",
        "    =====    ",
        "             ",
        " *$*     *$* ",
        "  *       *  ",
        "             ",
        "             "
      ]
    },
    {
      "name": "Spiked Corners",
      "layout": [
        "***         *",
        "* *         *",
        "* *         *",
        "             ",
        "             ",
        "             ",
        "             ",
        "             ",
        "             ",
        "*         * *",
        "*         * *",
        "*         * *",
        "*         ***"
      ]
    },
    {
      "name": "Diagonal Trap Cross",
      "layout": [
        "             ",
        "  #       #  ",
        " *         * ",
        "  *       *  ",
        "    *   *    ",
        "     ***     ",
        "     * *     ",
        "     ***     ",
        "    *   *    ",
        "  *       *  ",
        " *         * ",
        "  #       #  ",
        "             "
      ]
    },
    {
      "name": "Diamond Arrow Gauntlet",
      "layout": [
        "             ",
        "    $   $    ",
        "     # #     ",
        "             ",
        "    *   *    ",
        "     ***     ",
        "     * *     ",
        "     ***     ",
        "    *   *    ",
        "             ",
        "     # #     ",
        "    $   $    ",
        "             "
      ]
    },
    {
      "name": "Inner Fortress",
      "layout": [
        "             ",
        "             ",
        "     ###     ",
        "    #    #   ",
        "   # *** #   ",
        "  # *   * #  ",
        "   *     *   ",
        "  # *   * #  ",
        "   # *** #   ",
        "    #    #   ",
        "     ###     ",
        "             ",
        "             "
      ]
    }
  ]
}
