{
  "rooms": [
    {
      "name": "Crossroads Trap Room",
      "layout": [
        "0000000000000",
        "0000000000000",
        "000000$000000",
        "000000*000000",
        "###000*000###",
        "000000*000000",
        "0000*****0000",
        "000000*000000",
        "###000*000###",
        "000000*000000",
        "000000$000000",
        "0000000000000",
        "0000000000000"
      ]
    },
    {
      "name": "Spike Maze",
      "layout": [
        "000*000$00000",
        "00*0#00#0*000",
        "0*00#00#00*00",
        "*00000000000*",
        "0000#000#0000",
        "0000#000#0000",
        "0000000000000",
        "0000#000#0000",
        "0000#000#0000",
        "*00000000000*",
        "0*00#00#00*00",
        "00*0#00#0*000",
        "000*000$00000"
      ]
    },
    {
      "name": "Arrow Gauntlet",
      "layout": [
        "0000000000000",
        "0000000000000",
        "$$$$00000$$$$",
        "0000000000000",
        "0000#0#0#0000",
        "0000#0#0#0000",
        "0000000000000",
        "0000#0#0#0000",
        "0000#0#0#0000",
        "0000000000000",
        "$$$$00000$$$$",
        "0000000000000",
        "0000000000000"
      ]
    },
    {
      "name": "Trap Arena",
      "layout": [
        "0000000000000",
        "0000000000000",
        "00*0000000*00",
        "0*$*000000*$*0",
        "0000000000000",
        "0000===000000",
        "0000=0=000000",
        "0000===000000",
        "0000000000000",
        "0*$*000000*$*0",
        "00*0000000*00",
        "0000000000000",
        "0000000000000"
      ]
    },
    {
      "name": "Spiked Corners",
      "layout": [
        "***000000000*",
        "*0*000000000*",
        "*0*000000000*",
        "0000000000000",
        "0000000000000",
        "0000000000000",
        "0000000000000",
        "0000000000000",
        "0000000000000",
        "*000000000*0*",
        "*000000000*0*",
        "*000000000*0*",
        "*000000000***"
      ]
    },
    {
      "name": "Diagonal Trap Cross",
      "layout": [
        "0000000000000",
        "00#0000000#00",
        "0*000000000*0",
        "00*0000000*00",
        "0000*000*0000",
        "00000***00000",
        "00000*0*00000",
        "00000***00000",
        "0000*000*0000",
        "00*0000000*00",
        "0*000000000*0",
        "00#0000000#00",
        "0000000000000"
      ]
    },
    {
      "name": "Diamond Arrow Gauntlet",
      "layout": [
        "0000000000000",
        "0000$000$0000",
        "00000#0#00000",
        "0000000000000",
        "0000*000*0000",
        "00000***00000",
        "00000*0*00000",
        "00000***00000",
        "0000*000*0000",
        "0000000000000",
        "00000#0#00000",
        "0000$000$0000",
        "0000000000000"
      ]
    },
    {
      "name": "Inner Fortress",
      "layout": [
        "0000000000000",
        "0000000000000",
        "00000###00000",
        "0000#0000#000",
        "000#0***0#000",
        "00#0*000*0#00",
        "000*00000*000",
        "00#0*000*0#00",
        "000#0***0#000",
        "0000#0000#000",
        "00000###00000",
        "0000000000000",
        "0000000000000"
      ]
    }
  ]
}
